XXXXXXXXXXXXXXXXXXXXXXXXXXXXXXXXXXXXXXXXXXXXXXXXXXXXXXXXXXXXXXXXXXXXXXXXXXXXXXXXXXXXX
XXXXXXXXXXXXXXXXXXXXXXXXXXXXXXXXXXXXXXXXXXXXXXXXXXXXXXXXXXXXXXXXXXXXXXXXXXXXXXXXXXXXX
XXXXXXXXXXXXXXXXXXXXXXXXXXXXXXXXXXXXXXXXXXXXXXXXXXXXXXXXXXXXXXXXXXXXXXXXXXXXXXXXXXXXX
XXXXXXXXXXXXXXXXXXXXXXXXXXXXXXXXXXXXXXXXXXXXXXXXXXXXXXXXXXXXXXXXXXXXXXXXXXXXXXXXXXXXX
XXXXXXXXXXXXXXXXXXXXXXXXXXXXXXXXXXXXXXXXXXXXXXXXXXXXXXXXXXXXXXXXXXXXXXXXXXXXXXXXXXXXX
XXXXXXXXXXXXXXXSSSSSSXXXXXXXXXXXXXXXXXSSSSSSSSYScSSSSXXXXXXXXXXXXXXXXXXXXXXXXXXXXXXXX
XXXXXXXXXXXXXSSSSSSSSSSSSSSSSXXXSSSSSSSSSSSSSScSSSSSSSSSSSXXXXXXXXXXXXXXXXXXXXXXXXXXX
XXXXXXXXXXSSSSSSSSSSSSSSSSSSSSSSSSSSSSSSSSSSSSSSSSSSSSSScSSSSXXXXXXXXXXXXXXXXXXXXXXXX
XXXXXXXXXSSSSSSSSSSSSSSSSSSSSSSSSSSSSSSSSSSSSSSSSSSSSSSSSrrSYSXXXXXXXXXXXXXXXXXXXXXXX
XXXXXXXXXSSSSSSSSSSSSSSSSSSSSSSSSSSSSSSSSSSSSSSSSSSSSSSSwwrSSYSSXXXXXXXXXXXXXXXXXXXXX
XXXXXXXXSSSSSSSSSSSSSSSSSSSSSSSSSSSScSSSSSSSSSSrSSSSSSSSSSSSYSYSSXXXXXXXXXXXXXXXXXXXX
XXXXXXXSSSSSSSSSSSSScccSccSSSSSSSSSScSSSSSSccSSSSSSSSSSSSSSSYSSSXXXXXXXXXXXXXXXXXXXXX
XXXXXXXSSSSSSSccScccScccSSSSSScSSSSSSSSScSSSSSSSSSSSSSSSSSS11SSSXXXXXXXXXXXXXXXXXXXXX
XXXXXXXSSSSSSccSSSSSSSSSSSSSScSSSSSSSSSSSSSSSSSSSSSSSSSSSS1221SSSSXXXXXXXXXXXXXXXXXXX
XXXXXXXSSSSSSSSSSSSSSSSSSSSSSSSSSSSSSScSSSScSSSSSSSSSSSSSS12222SSXXXXXXXXXXXXXXXXXXXX
XXXXXXSSSSSSScSSSSSSSSSSSSSSSSSSSSSSSScSSSSSSSccSSSSSSSSSSS112SSXXXXXXXXXXXXXXXXXXXXX
XXXXXXSSSSSSSSSS2SSwwSYSYrSSSSSSSSSSrSSScccSSSScccSSSSSSSSSS22SSSXXXXXXXXXXXXXXXXXXXX
XXXXXXSSSScYrSSSYrSwwSSSrSSSSSSSSSSrSSSSSSSSSSSSSSSSSSSSSSS22SSSSXXXXXXXXXXXXXXXXXXXX
XXXXXXSSSccrSSSrrSSSSSSSSSSSSYSSSSSSYSrSSSSSSSSSSSScSSSSSS22SSSSSSXXXXXXXXXXXXXXXXXXX
XXXXXXSSScrSSSSSSSSYS222222SrrSSSSSrSScSSSSSSSSSYSccSSSSSS2SSSSSXXXXXXXXXXXXXXXXXXXXX
XXXXXSSSSSSSSSwwSSSr22SSSS22YrSYSSSSSScSSSSSSSrrSScSSSSSSS2SSSSSXXXXXXXXXXXXXXXXXXXXX
XXXXXSSSrSSSSwwwwwSS22S112S2SSSSSSSSSSSSSSSrSSSSSccSSSSSS22SSSSSXXXXXXXXXXXXXXXXXXXXX
XXXXXSSrYSSSSwwXwwwS2YS2S2S22SSSScSSSSSSSSSSYSSSSSSSSSSS22SSSSSSXXXXXXXXXXXXXXXXXXXXX
XXXXSSSSrSSSSwwXXXwS22r1S1SS2SSSSccSScccSSSrSrSSSSSSSSS222SSSSSXXXXXXXXXXXXXXXXXXXXXX
XXXXSSSSSSSSSwwXXwwS22S1S2S22SSSccSSSSSSSSSSSSSSSSSSSS22SSSSSSSXXXXXXXXXXXXXXXXXXXXXX
XXXXSSSSSrSSSwwwwwwS22rSSS22SSSSSSSSrSYSSSSSSSSSSSScS222SSSSSSSXXXXXXXXXXXXXXXXXXXXXX
XXXXSSSSSrYSSwwwwwwS2222222SSSccScSSSSSSSSSSSScSSSSS22SSSSSSSSSSSXXXXXXXXXXXXXXXXXXXX
XXXXSSSSSSSrSSwwwwwSSSSSSS22SSSScSSrrSSSSSSScccSSS222SSSSSSSSSXSXXXXXXXXXXXXXXXXXSSSS
XXXXSSSSSSSYSSSwwSSrSSSSSSS2SSSSSSSSSSSSSSSScSSSS22SSSSSSSSSSXXXXXXXXXXXXXXXXXXXSSSSS
XXXXSSSSSSSrSSSwwSYrSSSScSS22SSccSSYSSSSSSScSSSS22SSSSSSSSSSSXXXXXXXXXXXXXXXXXSSSSrSS
XXXXSSSScSSrSSSwwSrSSSScScSS2SSScSrSSSSrSSScSSSS2SSSSSSSSSSSXXXXXXXXXXXXXXXXXSSSSSSSS
XXXXXSSSSSrYSSSwwSSSSSSSSSSS22SSSSSSrSSrSSccSS222SSSSSSSSSSXXXXXXXXXXXXXXXXXSSYSYSrYS
XXXXXSSScSSrrSSwwSSSSScSSSSSS22SSSSSSSYSSSSSS22SSSSSSSSSSSSXXXXXXXXXXXXXXXXSSSSSSSrrS
XXXXXSSScSSSSSSwwSSSSScccSScSS22SSccS1S1ScSS22SSSSSSSSSrSSXXXXXXXXXXXXXXXXXSSSSSSSSSS
XXXXXXSSccSSSSSwwSSSSScccSSScSS22SSc12SSr1S22SScSSSSSSYrSSXXXXXXXXXXXXXXXXSSSSSSSSYSS
XXXXXXXSSccSSSwwwSSSScSSccSSSScS222SS22SSS22ScccSSSSSSrSSSXXXXXXXXXXXXXXXXSSSSSYSSSSS
XXXXXXXSSSSSSSwwSSSSccSSScccSSSSSS22S1Sr122ScrSSSSSSSSSSSSXXXXXXXXXXXXXXXXXSSSSSSSSSr
XXXXXXXXSSSSSSwwSSSSccSSSSSSSSSSSSSS22SS2SSScSSSSSSSSSSSSSXXXXXXXXXXXXXXXXXSSSYSSSrSS
XXXXXXXXXSSSSSwwSSScScSSSSSSSSSScSrSS2222SScrSSccSSSSSSSSSXXXXXXXXXXXXXXXXXXXSSSSYrrS
XXXXXXXXXXSSSSwwSSScSSSSwSSSSSSrYSYSrS22SSrSSSSSSSSSSrSYSSSXXXXXXXXSSSXXXXXXXXSSSSSYS
XXXXXXXXXXXSSwwwSSScSSSSSSSSSSSSSwwrS22cScSSScSSSSSSSSSrrSSXXXXXXXXSSSSXXXXXXXSSSSSSS
XXXXXXXXXXXSSwwSSSSSccSSSS211SSrSYSS22SrrSSSSSSSSSSSSSSSSSSXXXXXXXXSSSSSXXXXXXXSSSSSS
XXXXXXXXXXXwwwSSSSSSSSSSS1SSS2SSSSSS2ScSSSSSSSSccSSSSSSSSSSXXXXXXXXSSYrSSXXXXXXXSYrSS
XXXXXXXXXXwwwSSSSSScSSSSS1SSS2SSSS222rSSSSSSSSSSSSSSSSSSSSSXXXXXXXXXSrSSSSXXXXXXSYYrY
XXXXXXXXXwwwSSSSScSSSSSSS2211SSSS22SSSSccrYSSSSSSSSccSSSSSSSXXXXXXXXXSSYSSXXXXXXSSrSS
XXXXXXXXXwwSSSSSScSSSSSSSSSSSSS222SSccSSSSSSSSSSccccSSSSSSSSXXXXXXXXXXSrSSSSXXXXXSSSS
XXXXXXXXXSSSSSSSccSccSSSSSSSSSS2SSSccSSSSSrSSSSccSSSSSSSSSSSSXXXXXXXXXSSSSSSXXXXXSSSS
XXXXXXXXXSSSSSSScSSScccScSSSSS22SSScSSSSSSSSSSSSSSSSSSSSSSSSSSXXXXXXXXXSSSSSSXSXXSSSS
XXXXXXXXXSSSScccSSSSSSSccSSSS22SSSScSSccSSScSSSSSScccccSSSSSSSSSXXXXXXXXSSSrSSSSSSSSS
XXXXXXXXSSSSccSccSSSSSSSSSSS22SSSSccSSSSSSccSSSSSccSSSScSSSSSSSSSXXXXXXXXSSSSSSSSSSYS
XXXXXXXXSSSScSSSScScccScrSSS2SSScSSSSSSSSccSSSSSSSSSSSSSSSSSSSSSSXXXXXXXXXXSYrSrYrSSS
XXXXXXXSSSScSSScScccSSSccSSS2ScrccrSSSSSSccSSSScSSSSSSSSSSSSSSSSSSXXXXXXXXXXXSSSSSSSS
XXXXXXSSSSScSSccSccSSSSScrSS2SSSSccSSSSSccSSSSSSSSSSSSSSSSSSSSSSSXXXXXXXXXXXXXXXXSSSS
XXXXXSSSSSScSSSccccSSSSScSSS2SSSSSrSSSSSSSSSSrYSSSSSSSSSSSSSScSSSXXXXXXXXXXXXXXXXXXXX
XXXXXSSSSSSSSccccccSSSSScrSS2SSSSSccSSSSSSSSSSSSSSSSSSSSSSSSScSSSSXXXXXXXXXXXXXXXXXXX
XXXXXSSSSSSccScSSccSSSSSrcSS2SSScccSSSSSSrrYSrrSSrSYSXXXSSSSSSSSSXXXXXXXXXXXXXXXXXXXX
XXXXXSSSSSSSccSccccSSSSScSSS2SrSSSrSSSSSSSSSrSSSrSSSSXXXSSSSSSSSSXXXXXXXXXXXXXXXXXXXX
XXXXSSSSSSSccScScccSSSSSccrS2SSSSrSSSSSSSSSSSSSSSSSSXXXXSSSSSSSSSXXXXXXXXXXXXXXXXXXXX
XXXXSSSSSScSScSSccSSScccSrcS2SSSSSSSSSSSSSSSSSSSSSSSXXXXSSScSSSSSXXXXXXXXXXXXXXXXXXXX
XXXXSSSSSScScccccSSSSSSSSSSS2SSSScccccccSSSSSSSSSSSSXXXXSSSSSSSSSXXXXXXXXXXXXXXXXXXXX
XXXXSSSSSSccSSSSSSSSScSSSSSS2SSSScSSSSScSSSSSSSSSSSSXXXXSSScSSSSSSXXXXXXXXXXXXXXXXXXX
XXXXSSSSSScSSSSSSSScSScSSrS22SSSScSSScSSSSSSS1SSSSSSXXXXXSScccSSSSXXXXXXXXXXXXXXXXXXX
XXXXSSSSSScSSSSSSSSSSScSSSS2SSSScScSScSSSSSS121SSSSSXXXXXSSSSccSSXXXXXXXXXXXXXXXXXXXX
XXXSSSSSSScccSSSSSSSSSSSSS22SSrSSccSSSSSSSS12221SSSSXXXXXSSSSScSSXXXXXXXXXXXXXXXXXXXX
XXXSSSSSSccccSSSccScSSSSSS2SSSSSSSSSSSSS11122221SSSXXXXXXSSSSSSSSSXXXXXXXXXXXXXXXXXXX
XXXSSSSSccccSSYSSSScSSSSrS2SSrS222SSSSS122222221SSSXXXXXXXSSSSSSSXXXXXXXXXXXXXXXXXXXX
XXXSSScScccSSSSSSSScSSSSSS2SS222S22SSSSS22222221SSSXXXXXXXXXXXSSSXXXXXXXXXXXXXXXXXXXX
XXSSSSccScSSS1111SScSSSSSS2222rrYS22222222222221SSSXXXXXXXXXXXXXXXXXXXXXXXXXXXXXXXXXX
XXSSSSccSSSS122221SSScSSSS2SSSSSScrSSSS122222221SSSXXXXXXXXXXXXXXXXXXXXXXXXXXXXXXXXXX
XSSSSScSSSSS122222SS2222222SSSSSSrSSSSS122222221SSSXXXXXXXXXXXXXXXXXXXXXXXXXXXXXXXXXX
XSSSSScScSSS122222222SSwwr222SSSSSSSSSSS1111111SSSSSXXXXXXXXXXXXXXXXXXXXXXXXXXXXXXXXX
XSSSSScccSSS122221SSSSrwwwXwwwwSScSSSSSSSSSSSSSSSSSSSXXXXXXXXXXXXXXXXXXXXXXXXXXXXXXXX
XXSSSSccSSSSS1111SSSSSwwXXXXwwwrSSccSSSSSSYSSSSSSSSSSXXXXXXXXXXXXXXXXXXXXXXXXXXXXXXXX
XXXSSSSSSSccSSSSSScSSSwXXXXXXXwwSSccSSSScSSSSSSSSSSSSSXXXXXXXXXXXXXXXXXXXXXXXXXXXXXXX
XXXXSSSSSSSSSSSccSccSSwwXXXXXXwwSSScSSSSSSSSSScSSSSSSSXXXXXXXXXXXXXXXXXXXXXXXXXXXXXXX
XXXXXSSSSSSSSSSSSSccSrwwwXXXXXwwSScScSSSSSSSSSSSSSSSSXXXXXXXXXXXXXXXXXXXXXXXXXXXXXXXX
XXXXXXSSSScScScSccccSSSwwXXXXXwwSSSSSccSSSSSSSSSSSSSXXXXXXXXXXXXXXXXXXXXXXXXXXXXXXXXX
XXXXXXXSSSSScSSSSSccSSSwwwXXXwwrSSSScccSSSSSSSSSSSSXXXXXXXXXXXXXXXXXXXXXXXXXXXXXXXXXX
XXXXXXXXXSSSSccSSSSccSSSSwXXXwrSSSccSScSSScSSSSSSSXXXXXXXXXXXXXXXXXXXXXXXXXXXXXXXXXXX
XXXXXXXXXXSSSSScSSSSSSSSwXXwwSSSSScSSSccSScSSSSSSXXXXXXXXXXXXXXXXXXXXXXXXXXXXXXXXXXXX
XXXXXXXXXXXSSSSSSSSSSSSSXXwSSSSSSSSSSSSSSSccSSSSXXXXXXXXXXXXXXXXXXXXXXXXXXXXXXXXXXXXX
XXXXXXXXXXXXSSSSSSSSSSSSXXSSSSSSSSSSSSSSSSSSSSSXXXXXXXXXXXXXXXXXXXXXXXXXXXXXXXXXXXXXX
XXXXXXXXXXXXXSSSXXXSSSSSXXSSSSSSSXXXSSSSSSSSSSSSXXXXXXXXXXXXXXXXXXXXXXXXXXXXXXXXXXXXX
XXXXXXXXXXXXXXSSXXXXXSSSXXSSSSSSXXXXSSXXXXXXXSSXXXXXXXXXXXXXXXXXXXXXXXXXXXXXXXXXXXXXX
XXXXXXXXXXXXXXXSXXXXXXXXXXXXXXXXXXXXXXXXXXXXXXXXXXXXXXXXXXXXXXXXXXXXXXXXXXXXXXXXXXXXX
XXXXXXXXXXXXXXXXXXXXXXXXXXXXXXXXXXXXXXXXXXXXXXXXXXXXXXXXXXXXXXXXXXXXXXXXXXXXXXXXXXXXX
XXXXXXXXXXXXXXXXXXXXXXXXXXXXXXXXXXXXXXXXXXXXXXXXXXXXXXXXXXXXXXXXXXXXXXXXXXXXXXXXXXXXX