XXXXXXXSSSSSSSSSSSSSSSSSSSSSSSSSSSSSSSSSSSSSSSSSSSSSSSSSSSSSSSSSSSSSSSXXXXXXXXXXXXXSS
SSSSSSSSSSSSSSSSSSSSSSSSSSSSSSSSSSSSSSSSSSSSSSSSSSSSSSSSSSSSSSXXXXXXXXXXXXXX?X?S?S?Y?
SSSSSSSSSSSS?SSSSSSSSSSSSSSSSSSSSSSSSSSSSSSSSSSSSSSSSSSSSSYSSSSSXXXXXXXXXXXX?S?S?S?S?
SSSSSSSSSXSS2SSSSSSSSSSSSSSSSSSSSSSSSSSSSSSSSSSSSSSSSSSScYScSSSSSSXXXXXXXXXS?S?S?S?S?
SSSSSSSSSSSSSSSSSSSSSSSSSSSSSSSSSSSSSSSSSSSSSSSSSSSSSSSSSSSSSSSSSSSXXXXXXSXS?S?S?S?S?
SSSSSSSSSSSSSSSSSSSSSSSSSSSSSSSSSSSSSSSSSSSSSSYScSSSSSSSSSSSSSSSSSXXXXXXXXXS?S?S?S?S?
SSSSSSSSSSSSSSSSSSSSSSSSSSSSSSSSSSSSSSSSSSSSSScSSSSSSSSSSSSSSSSSXXXXXXXXXXXS?S?S?S?S?
SSSSSSSSSSSSSSSSSSSSSSSSSSSSSSSSSSSSSSSSSSSSSSSSSSSSSSSScSSSSSSSXXXXXXXXXXXX?S?S?S?S?
SSSSSSSSSSSSSSSSSSSSSSSSSSSSSSSSSSSSSSSSSSSSSSSSSSSSSSSSSrrSYSSSXXXXXXXXXXXX?S?S?r?S?
SSSSSSSSSSSSSSSSSSSSSSSSSSSSSSSSSSSSSSSSSSSSSSSSSSSSSSSSwwrSSYSSXXXXXXXXXXXX?X?S?S?rw
SSSSSSSSSSSSSSSSSSSSSSSSSSSSSSSSSSSSSSSSSSSSSSSrSSSSSSSSSSSSYSYSSSXXXXXXXXXXXXXXXXXXX
SSSSSSSSSSSSSSSSSSSSSSSSSSSSSSSSSSSSSSSSSSSSSSSSSSSSSSSSSSSSYSSSSSXXXXXXXXXXXXXXXXXXX
SSSSSSSSSSSSSSSSSSSSSSSSSSSSSSSSSSSSSSSSSSSSSSSSSSSSSSSSSSSSSSSSSXXXXXXXXXXXXXXXXXXXX
SSSSSSSSSSSSSSSSSSSSSSSSSSSSSSSSSSSSSSSSSSSSSSSSSSSSSSSSSSSSSSSSSSXXXXXXXXXXXXXXXXXXX
SSSSSSSSSSSSSSSSSSSSSSSSSSSSSSSSSSSSSSSSSSSSSSSSSSSSSSSSSSSSS22SSSXXXXXXXXXXXXXXXXXXX
SSSSSSSSSSSSSSSSSSSSSSSSSSSSSSSSSSSSSSSSSSSSSSSSSSSSSSSSSSSSS2SSXXXXXXXXXXXXXXXXXXXXX
SSSSSSSSSSSSSSSS2SSwwSYSYrSSSSSSSSSSrSSSSSSSSSSSSSSSSSSSSSSS22SSSSXXXXXXXXXXXXXXXXXXX
SSSSSSSSSSSYrSSSYrSwwSSSrSSSSSSSSSSrSSSSSSSSSSSSSSSSSSSSSSS22SSSSSXXXXXXXXXXXXXXXXXXX
SSSSSSSSSSSrSSSrrSSSSSSSSSSSSYSSSSSSYSrSSSSSSSSSSSSSSSSSSS22SSSSSSXXXXXXXXXXXXXXXXXXX
SSSSSSSSSSrSSSSSSSSYS222222SrrSSSSSrSSSSSSSSSSSSYSSSSSSSSS2SSSSSXXXXXXXXXXXXXXXXXXXXX
SSSSSSSSSSSSSSwwSSSr22SSSS22YrSYSSSSSSSSSSSSSSrrSSSSSSSSSS2SSSSSSSXXXXXXXXXXXXXXXXXXX
SSSSSSSSrSSSSwwwwwSS22S112S2SSSSSSSSSSSSSSSrSSSSSSSSSSSSS22SSSSSSSXXXXXXXXXXXXXXXXXXX
SSSSSSSrYSSSSwwXwwwS2YS2S2S22SSSSSSSSSSSSSSSYSSSSSSSSSSS22SSSSSSSSXXXXXXXXXXXXXXXXXXX
SSSSSSSSrSSSSwwXXXwS22r1S1SS2SSSScSSSSSSSSSrSrSSSSSSSSS222SSSSSSXXXXXXXXXXXXXXXXXXXXX
SSSSSSSSSSSSSwwXXwwS22S1S2S22SSSSSSSSSSSSSSSSSSSSSSSSS22SSSSSSSSSSXXXXXXXXXXXXXXXXXXX
SSSSSSSSSrSSSwwwwwwS22rSSS22SSSSSSSSrSYSSSSSSSSSSSScS222SSSSSSSSSSXXXXXXXXXXXXXXXXXXX
SSSSSSSSSrYSSwwwwwwS2222222SSSccSSSSSSSSSSSSSScSSSSS22SSSSSSSSSSSSXXXXXXXXXXXXXXXXXXX
SSSSSSSSSSSrSSwwwwwSSSSSSS22SSSScSSrrSSSSSSScccSSS222SSSSSSSSSSSXXXXXXXXXXXXXXXXXXXXX
SSSSSSSSSSSYSSSwwSSrSSSSSSS2SSSSSSSSSSSSSSSScSSSS22SSSSSSSSSSSSSSSXXXXXXXXXXXXXXXXXXX
SSSSSSSSSSSrSSSwwSYrSSSScSS22SScSSSYSSSSSSScSSSS22SSSSSSSSSSSSSSSSXXXXXXXXXXXXXXXXXXX
SSSSSSSSSSSrSSSwwSrSSSScScSS2SSSSSrSSSSrSSScSSSS2SSSSSSSSSSSSSSSSSXXXXXXXXXXXXXXXXXXX
SSSSSSSSSSrYSSSwwSSSSSSSSSSS22SSSSSSrSSrSSccSS222SSSSSSSSSSSSSSSXXXXXXXXXXXXXXXXXXXXX
SSSSSSSSSSSrrSSwwSSSSSSSSSSSS22SSSSSSSYSSSSSS22SSSSSSSSSSSSScccSSSXXXXXXXXXXXXXXXXXXX
SSSSSSSSSSSSSSSwwSSSSSSccSScSS22SSccS1S1ScSS22SSSSSSSSScccccSScSSXXXXXXXXXXXXXXXXXXXX
SSSSSSSSSSSSSSSwwSSSSSSScSSScSS22SSc12SSr1S22SScSSSSccccSSSSSScSSXXXXXXXXXXXXXXXXXXXX
SSSSSccSSSSScSwwwSSSSSSSccSSSScS222SS22SSS22ScccSSSccSrSSSSSSScSSSXXXXXXXXXXXXXXXXXXX
SSSccSSSSSSScSwwSSSSSSSSScccSSSSSS22S1Sr122ScrSSSScSSSSSSSSSSScSSSXXXXXXXXXXXXXXXXXXX
SSccSSSSSSSScSwwSSSSSSSSSSSSSSSSSSSS22SS2SSScSSSSScSSSSSSSSSSccSSXXXXXXXXXXXXXXXXXXXX
SccSSSSSSSSccSwwSSSSSSSSSSSScccScSrSS2222SScrSSccSSSSSSSSSSSccSSSXXXXXXXXXXXXXXXXXXXX
ScSSSSSSScccSSwwSSSScScccccccSccYSYSrS22SSrSSSSScScSSrSYSSSScSSSXXXXXXXXXXXXXXXXXXXXX
cSSSSSSSccSSSwwwSScccccSSSSSSSccSwwrS22cScSSSccSSScSSSScrSccSSSSSSXXXXXXXXXXXXXXXXXXX
cSSSSSScSSSSSwwSSccScccSSS211SSrSYSS22SrrSSSSccSSScSSSSccccSSSSSSSXXXXXXXXXXXXXXXXXXX
cSSSSScSSSSSSwwSScScSccSS1SSS2SSSSSS2ScSSSSSccSSSSccSSSSSSSSSSSSSXXXXXXXXXXXXXXXXXXXX
cSSSScScSSSSSwwSSccSScccS1SSS2SSSS222rSSSSSccSSSccccccccSSSSSSSSSXXXXXXXXXXXXXXXXXXXX
cSSScScSScSSSwwSSSSSSSccS2211SSSS22SSSSccrcSScScSSccSSSScSccSSSSSXXXXXXXXXXXXXXXXXXXX
ccSScSSSSSSSSwwSSSSSSScccSSSSSS222SSccSSSccScccccccScSSSSSScccSSSSXXXXXXXXXXXXXXXXXXX
ScScSSSSSSSSSwwSSSSSSSSccSSSSSS2SSSccSSSccrccSSccccccSScSSSSccSSSXXXXXXXXXXXXXXXXXXXX
ScccSSSSccSSSSwwSSSSSSSSSSSSSS22SSScSSSScSccSSSSScccccScccccSSSSXXXXXXXXXXXXXXXXXXXXX
SSccSSScSSSSSSwwSSSSSSSSSSSSS22SSSScSSScSccSSSSSScccccccSSSSSSSSSSXXXXXXXXXXXXXXXXXXX
SSScSSSSSSSSSSwwSSSSSSSSSSSS22SSSSccSSScccSSSSSSccSSScccccSSSSSSSXXXXXXXXXXXXXXXXXXXX
SSSccSSSSSSSSSwwSSSSSSScrSSS2SSScSSSSSSccSSSSSSSccScSScSSccSSSSSSSXXXXXXXXXXXXXXXXXXX
SSSSccSSScSSSSwwSSSSSSSccSSS2ScrccrSSSSScSSSSSSSSccSSSScSSccSSSSSSXXXXXXXXXXXXXXXXXXX
SSSSScccSSSSSSSwwSSSSSSScrSS2SSSSccSSSSSSSSSSSSSSSccSSScSSSccSSSSXXXXXXXXXXXXXXXXXXXX
SSSSSSSSccSSSSSwwSSSSSSScSSS2SSSSSrSSSSSSSSSSrYSSSSSSSSScSSScSSSSXXXXXXXXXXXXXXXXXXXX
SSSSSSSSScccSSSSwwSSSSSScrSS2SSSSSccSSSSSSSSSSSSSSSSSSSSSccScSSSSSXXXXXXXXXXXXXXXXXXX
SSSSccSSSSScSSSSwwSSSSSSrcSS2SSScccSSSSSSrrYSrrSSrSYSSSSSScccSSSSXXXXXXXXXXXXXXXXXXXX
SSSScSSSSSSScSSSSwwSSSSScSSS2SrSSSrSSSSSSSSSrSSSrSSSScSSSSSSSSSSSXXXXXXXXXXXXXXXXXXXX
SScScSSSSSSccSSSSwwSSSSSccrS2SSSSrSSSSSSSSSSSSSSSSSSSccSSSSSSSSSSXXXXXXXXXXXXXXXXXXXX
SSSScSSSSSScSSSSSSwwSSSSSrcS2SSSSSSSSSSSSSSSSSSSSSSSSScSSSSSSSSSSXXXXXXXXXXXXXXXXXXXX
ScSScSSSSSccSSSSSSwwSSSSSSSS2SSSSSSSSSSSSSSSSSSSSSSSSScSSSSSSSSSSXXXXXXXXXXXXXXXXXXXX
SSSScSSSSScSSSSSSSSwwSSSSSSS2SSSSSSSSSccSSSSSSSSSSSSSSccSSSSSSSSSSXXXXXXXXXXXXXXXXXXX
SSScccSSScSSSSSSSSSwwSSSSrS22SSSSSSScccSSSSSS1SSSSSSSSccSSSSSSSSSSXXXXXXXXXXXXXXXXXXX
SSSSScccccSSSSSSSSSSwSSSSSS2SSSSSSSScSSSSSSS121SSSSSSScccSSSSSSSSXXXXXXXXXXXXXXXXXXXX
SSSSSSccSSSSSSSSSSSSwwSSSS22SSrSSSSScSSSSSS12221SSSSSScSSSSSSSSSSXXXXXXXXXXXXXXXXXXXX
SSSSSSSSSSSSSSSSSSScwwSSSS2SSSSSSSSSSSSS11122221SSSSSScSSSSSSSSSSSXXXXXXXXXXXXXXXXXXX
SSSSSSSSSSSSSSYSSSSSSwwSrS2SSrS222SSSSS122222221SSSSScccSSSSSSSSSXXXXXXXXXXXXXXXXXXXX
SSSScSSSSSSSSSSSSSScSwwccS2SS222S22SSSSS22222221SSSSSSccSSSSSSSSSXXXXXXXXXXXXXXXXXXXX
SSSSSSSSSSSSS1111SScSSwwcS2222rrYS22222222222221SSSSSccSSSSSSXXXXXXXXXXXXXXXXXXXXXXXX
SSSSSSSSSSSS122221SSScwwcS2SSSSSScrSSSS122222221SSSSccSSSSSXXXXXXXXXXXXXXXXXXXXXXXXXX
SSSSSSScSSSS122222SS2222222SSSSSSrSSSSS122222221SSSScSSSSSXXXXXXXXXXXXXXXXXXXXXXXXXXX
XSSSSScSSSSS122222222SSwwr222SSSSSSSSSSS1111111SSSSSSSSSSSXXXXXXXXXXXXXXXXXXXXXXXXXXX
XSSSSSSSSSSS122221SSSSrwwwXwwwwSScSSSSSSSSSSSSSSSSSSSSSSSXXXXXXXXXXXXXXXXXXXXXXXXXXXX
XXSSSSSScSSSS1111SSSSSwwXXXXwwwrSScSSSSSSSYSSSSSSSSSSSSSXXXXXXXXXXXXXXXXXXXXXXXXXXXXX
XXXSSSSSSSSSSSSSSScSSSwXXXXXXXwwSScSSSSSSSSSSSSSSSSSSSSXXXXXXXXXXXXXXXXXXXXXXXXXXXXXX
XXXXSSSSScSSSSSccSccSSwwXXXXXXwwSSSSSSSSSSSSSSSSSSSSSSXXXXXXXXXXXXXXXXXXXXXXXXXXXXXXX
XXXXXSSSScSccSScSSccSrwwwXXXXXwwSScSSSSSSSSSSSSSSSSSSXXXXXXXXXXXXXXXXXXXXXXXXXXXXXXXX
XXXXXXSSSScScSccccccSSSwwXXXXXwwSSSSSSSSSSSSSSSSSSSSXXXXXXXXXXXXXXXXXXXXXXXXXXXXXXXXX
XXXXXXXSSSScccSSScccSSSwwwXXXwwrSSSSSSSSSSSSSSSSSSSXXXXXXXXXXXXXXXXXXXXXXXXXXXXXXXXXX
XXXXXXXXXSSSSccSScSccSSSSwXXXwrSSSSSSSSSSSSSSSSSSSXXXXXXXXXXXXXXXXXXXXXXXXXXXXXXXXXXX
XXXXXXXXXXSSSSccSSSSSSSSwXXwwSSSSSSSSSSSSSSSSSSSSXXXXXXXXXXXXXXXXXXXXXXXXXXXXXXXXXXXX
XXXXXXXXXXXSSSSSccSSSSSSXXwSSSSSSSSSSSSSSSSSSSSSXXXXXXXXXXXXXXXXXXXXXXXXXXXXXXXXXXXXX
XXXXXXXXXXXXSSSSSSSSSSSSXXSSSSSSSSSSSSSSSSSSSSSXXXXXXXXXXXXXXXXXXXXXXXXXXXXXXXXXXXXXX
XXXXXXXXXXXXXSSSXXXSSSSSXXSSSSSSSXXXSSSSSSSSSSSSXXXXXXXXXXXXXXXXXXXXXXXXXXXXXXXXXXXXX
XXXXXXXXXXXXXXSSXXXXXSSSXXSSSSSSXXXXSSXXXXXXXSSXXXXXXXXXXXXXXXXXXXXXXXXXXXXXXXXXXXXXX
XXXXXXXXXXXXXXXSXXXXXXXXXXXXXXXXXXXXXXXXXXXXXXXXXXXXXXXXXXXXXXXXXXXXXXXXXXXXXXXXXXXXX
XXXXXXXXXXXXXXXXXXXXXXXXXXXXXXXXXXXXXXXXXXXXXXXXXXXXXXXXXXXXXXXXXXXXXXXXXXXXXXXXXXXXX
XXXXXXXXXXXXXXXXXXXXXXXXXXXXXXXXXXXXXXXXXXXXXXXXXXXXXXXXXXXXXXXXXXXXXXXXXXXXXXXXXXXXX