XXXXXXXSSSSSSSSSSSSSSSSSSSSSSSSSSSSSSSSSSSSSSSSSSSSSSSSSSSSSSSSSSSSSSSXXXXXXXXXXXXXSS
SSSSSSSSSSSSSSSSSSSSSSSSSSSSSSSSSSSSSSSSSSSSSSSSSSSSSSSSSSSSSSXXXXXXXXXXXXXX?X?S?S?Y?
SSSSSSSSSSSSSSSSSSSSSSSSSSSSSSSSSSSSSSSSSSSSSSSSSSSSSSSSSSYSSSSSXXXXXXXXXXXX?S?S?S?S?
SSSSSSSSSXSSSSSSSSSSSSSSSSSSSSSSSSSSSSSSSSSSSSSSSSSSSSSScYScSSSSSSXXXXXXXXXS?S?S?S?S?
SSSSSSSSSSSSSSSSSSSSSSSSSSSSSSSSSSSSSSSSSSSSSSSSSSSSSSSSSSSSSSSSSSSXXXXXXSXS?S?S?S?S?
SSSSSSSSSSSSSSSSSSSSSSSSSSSSSSSSSSSSSSSSSSSSSSYScSSSSSSSSSSSSSSSSSXXXXXXXXXS?S?S?S?S?
SSSSSSSSSSSSSSSSSSSSSSSSSSSSSSSSSSSSSSSSSSSSSScSSSSSSSSSSSSSSSSSXXXXXXXXXXXS?S?S?S?S?
SSSSSSSSSSSSSSSSSSSSSSSSSSSSSSSSSSSSSSSSSSSSSSSSSSSSSSSScSSSSSSSXXXXXXXXXXXX?S?S?S?S?
SSSSSSSSSSSSSSSSSSSSSSSSSSSSSSSSSSSSSSSSSSSSSSSSSSSSSSSSSrrSYSSSXXXXXXXXXXXX?S?S?r?S?
SSSSSSSSSSSSSSSSSSSSSSSSSSSSSSSSSSSSSSSSSSSSSSSSSSSSSSSSwwrSSYSSXXXXXXXXXXXX?X?S?S?rw
SSSSSSSSSSSSSSSSSSSSSSSSSSSSSSSSSSSSSSSSSSSSSSSrSSSSSSSSSSSSYSYSSSXXXXXXXXXXXXXXXXXXX
SSSSSSSSSSSSSSSSSSSSSSSSSSSSSSSSSSSSSSSSSSSSSSSSSSSSSSSSSSSSYSSSSSXXXXXXXXXXXXXXXXXXX
SSSSSSSSSSSSSSSSSSSSSSSSSSSSSSSSSSSSSSSSSSSSSSSSSSSSSSSSSSSSSSSSSXXXXXXXXXXXXXXXXXXXX
SSSSSSSSSSSSSSSSSSSSSSSSSSSSSSSSSSSSSSSSSSSSSSSSSSSSSSSSSSSSSSSSSSXXXXXXXXXXXXXXXXXXX
SSSSSSSSSSSSSSSSSSSSSSSSSSSSSSSSSSSSSSSSSSSSSSSSSSSSSSSSSSSSSSSSSSXXXXXXXXXXXXXXXXXXX
SSSSSSSSSSSSSSSSSSSSSSSSSSSSSSSSSSSSSSSSSSSSSSSSSSSSSSSSSSSSSSSSXXXXXXXXXXXXXXXXXXXXX
SSSSSSSSSSSSSSSS2SSSSSSSSSSSSSSSSSSSrSSSSSSSSSSSSSSSSSSSSSSSSSSSSSXXXXXXXXXXXXXXXXXXX
SSSSSSSSSSSYrSSSYrSSSSSSSSSSSSSSSSSrSSSSSSSSSSSSSSSSSSSSSSSSSSSSSSXXXXXXXXXXXXXXXXXXX
SSSSSSSSSSSrSSSrrSSSSSSSSSSSSSSSSSSSYSrSSSSSSSSSSSSSSSSSSSSSSSSSSSXXXXXXXXXXXXXXXXXXX
SSSSSSSSSSrSSSSSSSSYSSSSSYSSSSSSSSSrSSSSSSSSSSSSYSSSSSSSSSSSSSSSXXXXXXXXXXXXXXXXXXXXX
SSSSSSSSSSSSSSwwSSSrrSSSSSSSSSScSSSSSSSSSSSSSSrrSSSSSSSSSSSSSSSSSSXXXXXXXXXXXXXXXXXXX
SSSSSSSSrSSSSwwwwwSSSSSSSSSSSSSSSSSSSSSSSSSrSSSSSSSSSSSSSSSSSSSSSSXXXXXXXXXXXXXXXXXXX
SSSSSSSrYSSSSwwwwwwSSYSrSSSScSSSSSSSSSSSSSSSYSSSSSSSSSSS22SSSSSSSSXXXXXXXXXXXXXXXXXXX
SSSSSSSSrSSSSwwwwwwSSSrSSSSSSSSSScSSSSSSSSSrSrSSSSSSSSS222SSSSSSXXXXXXXXXXXXXXXXXXXXX
SSSSSSSSSSSSSwwwwwwSSSSSSSSSSSSSSSSSSSSSSSSSSSSSSSSSSS22SSSSSSSSSSXXXXXXXXXXXXXXXXXXX
SSSSSSSSSrSSSwwwwwwS2SrSSSSSSSSSSSSSrSYSSSSSSSSSSSScS222SSSSSSSSSSXXXXXXXXXXXXXXXXXXX
SSSSSSSSSrYSSwwwwwwS2222222SSSccSSSSSSSSSSSSSScSSSSS22SSSSSSSSSSSSXXXXXXXXXXXXXXXXXXX
SSSSSSSSSSSrSSwwwwwSSSSSSS22SSSScSSrrSSSSSSScccSSS222SSSSSSSSSSSXXXXXXXXXXXXXXXXXXXXX
SSSSSSSSSSSYSSSwwSSrSSSSSSS2SSSSSSSSSSSSSSSScSSSS22SSSSSSSSSSSSSSSXXXXXXXXXXXXXXXXXXX
SSSSSSSSSSSrSSSwwSYrSSSScSS22SScSSSYSSSSSSScSSSS22SSSSSSSSSSSSSSSSXXXXXXXXXXXXXXXXXXX
SSSSSSSSSSSrSSSwwSrSSSScScSS2SSSSSrSSSSrSSScSSSS2SSSSSSSSSSSSSSSSSXXXXXXXXXXXXXXXXXXX
SSSSSSSSSSrYSSSwwSSSSSSSSSSS22SSSSSSrSSrSSccSS222SSSSSSSSSSSSSSSXXXXXXXXXXXXXXXXXXXXX
SSSSSSSSSSSrrSSwwSSSSSSSSSSSS22SSSSSSSYSSSSSS22SSSSSSSSSSSSSSSSSSSXXXXXXXXXXXXXXXXXXX
SSSSSSSSSSSSSSSwwSSSSSSccSScSS22SSccS1S1ScSS22SSSSSSSSSrSSSSSSSSSXXXXXXXXXXXXXXXXXXXX
SSSSSSSSSSSSSSSwwSSSSSSScSSScSS22SSc12SSr1S22SScSSSSSSYrSSSSSSSSSXXXXXXXXXXXXXXXXXXXX
SSSSSSSSSSSSSSwwwSSSSSSSccSSSScS222SS22SSS22ScccSSSSSSrSSSSSSSSSSSXXXXXXXXXXXXXXXXXXX
SSSSSSSSSSSSSSwwSSSSSSSSScccSSSSSS22S1Sr122ScrSSSSSSSSSSSSSSSSSSSSXXXXXXXXXXXXXXXXXXX
SSSSSSSSSSSSSSwwSSSSSSSSSSSSSSSSSSSS22SS2SSScSSSSSSSSSSSSSSSSSSSSXXXXXXXXXXXXXXXXXXXX
SSSSSSSSSSSSSSwwSSSSSSSSSSSSSSSScSrSS2222SScrSSccSSSSSSSSSSSSSSSSXXXXXXXXXXXXXXXXXXXX
SSSSSSSSSSSSSSwwSSSSSSSSSSSSSSSrYSYSrS22SSrSSSSSSSSSSrSYSSSSSSSSXXXXXXXXXXXXXXXXXXXXX
SSSSSSSSSSSSSwwwSSSSSSSSSSSSSSSSSwwrS22cScSSScSSSSSSSSSrrSSSSSSSSSXXXXXXXXXXXXXXXXXXX
SSSSSSSSSSSSSwwSSSSSSSSSSS211SSrSYSS22SrrSSSSSSSSSSSSSSSSSSSSSSSSSXXXXXXXXXXXXXXXXXXX
SSSSSSSSSSSSSwwSSSSSSSSSS1SSS2SSSSSS2ScSSSSSSSSSSSSSSSSSSSSSSSSSSXXXXXXXXXXXXXXXXXXXX
SSSSSSSSSSSSSwwSSSSSSSSSS1SSS2SSSS222rSSSSSSSSSSSSSSSSSSSSSSSSSSSXXXXXXXXXXXXXXXXXXXX
SSSSSSSSSSSSSwwSSSSSSSSSS2211SSSS22SSSSccrYSSSSSSSSSSSSSSSSSSSSSSXXXXXXXXXXXXXXXXXXXX
SSSSSSSSSSSSSwwSSSSSSSSSSSSSSSS222SSccSSSSSSSSSSSSSSSSSSSSSSSSSSSSXXXXXXXXXXXXXXXXXXX
SSSSSSSSSSSSSwwSSSSSSSSSSSSSSSS2SSSccSSSSSrSSSSSSSSSSSSSSSSSSSSSSXXXXXXXXXXXXXXXXXXXX
SSSSSSSSSSSSSSwwSSSSSSSSSSSSSS22SSScSSSSSSSSSSSSSSSSSSSSSSSSSSSSXXXXXXXXXXXXXXXXXXXXX
SSSSSSSSSSSSSSwwSSSSSSSSSSSSS22SSSScSSSSSSSSSSSSSSSSSSSSSSSSSSSSSSXXXXXXXXXXXXXXXXXXX
SSSSSSSSSSSSSSwwSSSSSSSSSSSS22SSSSccSSSSSSSSSSSSSSSSSSSSSSSSSSSSSXXXXXXXXXXXXXXXXXXXX
SSSSSSSSSSSSSSwwSSSSSSScrSSS2SSScSSSSSSSSSSSSSSSSSSSSSSSSSSSSSSSSSXXXXXXXXXXXXXXXXXXX
SSSSSSSSSSSSSSwwSSSSSSSccSSS2ScrccrSSSSSSSSSSSSSSSSSSSSSSSSSSSSSSSXXXXXXXXXXXXXXXXXXX
SSSSSSSSSSSSSSSwwSSSSSSScrSS2SSSSccSSSSSSSSSSSSSSSSSSSSSSSSSSSSSSXXXXXXXXXXXXXXXXXXXX
SSSSSSSSSSSSSSSwwSSSSSSScSSS2SSSSSrSSSSSSSSSSrYSSSSSSSSSSSSSSSSSSXXXXXXXXXXXXXXXXXXXX
SSSSSSSSSSSSSSSSwwSSSSSScrSS2SSSSSccSSSSSSSSSSSSSSSSSSSSSSSSSSSSSSXXXXXXXXXXXXXXXXXXX
SSSSSSSSSSSSSSSSwwSSSSSSrcSS2SSScccSSSSSSrrYSrrSSrSYSSSSSSSSSSSSSXXXXXXXXXXXXXXXXXXXX
SSSSSSSSSSSSSSSSSwwSSSSScSSS2SrSSSrSSSSSSSSSrSSSrSSSSSSSSSSSSSSSSXXXXXXXXXXXXXXXXXXXX
SSSSSSSSSSSSSSSSSwwSSSSSccrS2SSSSrSSSSSSSSSSSSSSSSSSSSSSSSSSSSSSSXXXXXXXXXXXXXXXXXXXX
SSSSSSSSSSSSSSSSSSwwSSSSSrcS2SSSSSSSSSSSSSSSSSSSSSSSSSSSSSSSSSSSSXXXXXXXXXXXXXXXXXXXX
SSSSSSSSSSSSSSSSSSwwSSSSSSSS2SSSSSSSSSSSSSSSSSSSSSSSSSSSSSSSSSSSSXXXXXXXXXXXXXXXXXXXX
SSSSSSSSSSSSSSSSSSSwwSSSSSSS2SSSSSSSSSSSSSSSSSSSSSSSSSSSSSSSSSSSSSXXXXXXXXXXXXXXXXXXX
SSSSSSSSSSSSSSSSSSSwwSSSSrS22SSSSSSSSSSSSSSSS1SSSSSSSSSSSSSSSSSSSSXXXXXXXXXXXXXXXXXXX
SSSSSSSSSSSSSSSSSSSSwSSSSSS2SSSSSSSSSSSSSSSS121SSSSSSSSSSSSSSSSSSXXXXXXXXXXXXXXXXXXXX
SSSSSSSSSSSSSSSSSSSSwwSSSS22SSrSSSSSSSSSSSS12221SSSSSSSSSSSSSSSSSXXXXXXXXXXXXXXXXXXXX
SSSSSSSSSSSSSSSSSSScwwSSSS2SSSSSSSSSSSSS11122221SSSSSSSSSSSSSSSSSSXXXXXXXXXXXXXXXXXXX
SSSSSSSSSSSSSSYSSSSSSwwSrS2SSrS222SSSSS122222221SSSSSSSSSSSSSSSSSXXXXXXXXXXXXXXXXXXXX
SSSSSSSSSSSSSSSSSSScSwwccS2SS222S22SSSSS22222221SSSSSSSSSSSSSSSSSXXXXXXXXXXXXXXXXXXXX
SSSSSSSSSSSSS1111SScSSwwcS2222rrYS22222222222221SSSSSSSSSSSSSXXXXXXXXXXXXXXXXXXXXXXXX
SSSSSSSSSSSS122221SSScwwcS2SSSSSScrSSSS122222221SSSSSSSSSSSXXXXXXXXXXXXXXXXXXXXXXXXXX
SSSSSSSSSSSS122222SS2222222SSSSSSrSSSSS122222221SSSSSSSSSSXXXXXXXXXXXXXXXXXXXXXXXXXXX
XSSSSSSSSSSS122222222SSwwr222SSSSSSSSSSS1111111SSSSSSSSSSSXXXXXXXXXXXXXXXXXXXXXXXXXXX
XSSSSSSSSSSS122221SSSSrwwwXwwwwSScSSSSSSSSSSSSSSSSSSSSSSSXXXXXXXXXXXXXXXXXXXXXXXXXXXX
XXSSSSSSSSSSS1111SSSSSwwXXXXwwwrSScSSSSSSSYSSSSSSSSSSSSSXXXXXXXXXXXXXXXXXXXXXXXXXXXXX
XXXSSSSSSSSSSSSSSScSSSwXXXXXXXwwSScSSSSSSSSSSSSSSSSSSSSXXXXXXXXXXXXXXXXXXXXXXXXXXXXXX
XXXXSSSSSSSSSSSccSccSSwwXXXXXXwwSSSSSSSSSSSSSSSSSSSSSSXXXXXXXXXXXXXXXXXXXXXXXXXXXXXXX
XXXXXSSSSSSSSSSSSSccSrwwwXXXXXwwSScSSSSSSSSSSSSSSSSSSXXXXXXXXXXXXXXXXXXXXXXXXXXXXXXXX
XXXXXXSSSScScScSScccSSSwwXXXXXwwSSSSSSSSSSSSSSSSSSSSXXXXXXXXXXXXXXXXXXXXXXXXXXXXXXXXX
XXXXXXXSSSSSSSSSSSccSSSwwwXXXwwrSSSSSSSSSSSSSSSSSSSXXXXXXXXXXXXXXXXXXXXXXXXXXXXXXXXXX
XXXXXXXXXSSSSccSSSSccSSSSwXXXwrSSSSSSSSSSSSSSSSSSSXXXXXXXXXXXXXXXXXXXXXXXXXXXXXXXXXXX
XXXXXXXXXXSSSSScSSSSSSSSwXXwwSSSSSSSSSSSSSSSSSSSSXXXXXXXXXXXXXXXXXXXXXXXXXXXXXXXXXXXX
XXXXXXXXXXXSSSSSSSSSSSSSXXwSSSSSSSSSSSSSSSSSSSSSXXXXXXXXXXXXXXXXXXXXXXXXXXXXXXXXXXXXX
XXXXXXXXXXXXSSSSSSSSSSSSXXSSSSSSSSSSSSSSSSSSSSSXXXXXXXXXXXXXXXXXXXXXXXXXXXXXXXXXXXXXX
XXXXXXXXXXXXXSSSXXXSSSSSXXSSSSSSSXXXSSSSSSSSSSSSXXXXXXXXXXXXXXXXXXXXXXXXXXXXXXXXXXXXX
XXXXXXXXXXXXXXSSXXXXXSSSXXSSSSSSXXXXSSXXXXXXXSSXXXXXXXXXXXXXXXXXXXXXXXXXXXXXXXXXXXXXX
XXXXXXXXXXXXXXXSXXXXXXXXXXXXXXXXXXXXXXXXXXXXXXXXXXXXXXXXXXXXXXXXXXXXXXXXXXXXXXXXXXXXX
XXXXXXXXXXXXXXXXXXXXXXXXXXXXXXXXXXXXXXXXXXXXXXXXXXXXXXXXXXXXXXXXXXXXXXXXXXXXXXXXXXXXX
XXXXXXXXXXXXXXXXXXXXXXXXXXXXXXXXXXXXXXXXXXXXXXXXXXXXXXXXXXXXXXXXXXXXXXXXXXXXXXXXXXXXX