XXXXXXXXXXXXXXXXXXXXXXXXXXXXXXXXXXXXXXXXXXXXXXXXXXXXXXXXXXXXXXXXXXXXXXXXXXXXXXXXXXXXX
XXXXXXXXXXXXXXXXXXXXXXXXXXXXXXXXXXXXXXXXXXXXXXXXXXXXXXXXXXXXXXXXXXXXXXXXXXXXXXXXXXXXX
XXXXXXXXXXXXXXXXXXXXXXXXXXXXXXXXXXXXXXXXXXXXXXXXXXXXXXXXXXXXXXXXXXXXXXXXXXXXXXXXXXXXX
XXXXXXXXXXXXXXXXXXXXXXXXXXXXXXXXXXXXXXXXXXXXXXXXXXXXXXXXXXXXXXXXXXXXXXXXXXXXXXXXXXXXX
XXXXXXXXXXXXXXXXXXXXXXXXXXXXXXXXXXXXXXXXXXXXXXXXXXXXXXXXXXXXXXXXXXXXXXXXXXXXXXXXXXXXX
XXXXXXXXXXXXXXXSSSSSSXXXXXXXXXXXXXXXXXSSSSSSSSYScSSSSXXXXXXXXXXXXXXXXXXXXXXXXXXXXXXXX
XXXXXXXXXXXXXSSSSSSSSSSSSSSSSXXXSSSSSSSSSSSSSScSSSSSSSSSSSXXXXXXXXXXXXXXSSSSSSSSXXXXX
XXXXXXXXXXSSSSSSSSSSSSSSSSSSSSSSSSSSSSSSSSSSSSSSSSSSSSSScSSSSXXXXXXXXXXScSSSSYSSSXXXX
XXXXXXXXXSSSSSSSSSSSSSSSSSSSSSSSSSSSSSSSSSSSSSSSSSSSSSSSSrrSYSXXXXXXXXSYcSwwcSScSXXXX
XXXXXXXXXSSSSSSSSSSSSSSSSSSSSSSSSSSSSSSSSSSSSSSSSSSSSSSSwwrSSYSSXXXXXSSYSwwwSSYcSSXXX
XXXXXXXXSSSSSSSSSSSSSSSSSSSSSSSSSSSScSSSSSSSSSSrSSSSSSSSSSSSYSYSSXXXXSSSwXXwSSSSScXXX
XXXXXXXSSSSSSSSSSSSScccSccSSSSSSSSSScSSSSSSccSSSSSSSSSSSSSSSYSSSwXXXXSXwXXXXwcSSSSXXX
XXXXXXXSSSSSSSccScccScccSSSSSScSSSSSSSSScSSSSSSSSSSSSSSSSSS11SSSwXXXXXXXXXXwwcSYSYXXX
XXXXXXXSSSSSSccSSSSSSSSSSSSSScSSSSSSSSSSSSSSSSSSSSSSSSSSSS1221SSwXXXXXXXXXXwSSSSSSXXX
XXXXXXXSSSSSSSSSSSSSSSSSSSSSSSSSSSSSSScSSSScSSSSSSSSSSSSSS12222SwXXXXSSwwwwSSSScYSXXX
XXXXXXSSSSSSScSSSSSSSSSSSSSSSSSSSSSSSScSSSSSSSccSSSSSSSSSSS112SSwXXXXSSSSSSSYSYSSSXXX
XXXXXXSSSSSSSSSS2SSwwSYSYrSSSSSSSSSSrSSScccSSSScccSSSSSSSSSS22SSwXXXXXSSScSSSSSSSXXXX
XXXXXXSSSScYrSSSYrSwwSSSrSSSSSSSSSSrSSSSSSSSSSSSSSSSSSSSSSS22SSSSwXXXXXXXXXcSSXXXXXXX
XXXXXXSSSccrSSSrrSSSSSSSSSSSSYSSSSSSYSrSSSSSSSSSSSScSSSSSS22SSSSSSXXXXXXXXXXXXXXXXXXX
XXXXXXSSScrSSSSSSSSYS222222SrrSSSSSrSScSSSSSSSSSYSccSSSSSS2SSSSSXXXXXXXXXXXXXXXXXXXXX
XXXXXSSSSSSSSSwwSSSr22SSSS22YrSYSSSSSScSSSSSSSrrSScSSSSSSS2SSSSSXXXXXXXXXXXXXXXXXXXXX
XXXXXSSSrSSSSwwwwwSS22S112S2SSSSSSSSSSSSSSSrSSSSSccSSSSSS22SSSSSXXXXXXXXXXXXXXXXXXXXX
XXXXXSSrYSSSSwwXwwwS2YS2S2S22SSSScSSSSSSSSSSYSSSSSSSSSSS22SSSSSSXXXXXXXXXXXXXXXXXXXXX
XXXXSSSSrSSSSwwXXXwS22r1S1SS2SSSSccSScccSSSrSrSSSSSSSSS222SSSSSXXXXXXXXXXXXXXXXXXXXXX
XXXXSSSSSSSSSwwXXwwS22S1S2S22SSSccSSSSSSSSSSSSSSSSSSSS22SSSSSSSXXXXXXXXXXXXXXXXXXXXXX
XXXXSSSSSrSSSwwwwwwS22rSSS22SSSSSSSSrSYSSSSSSSSSSSScS222SSSSSSSXXXXXXXXXXXXXXXXXXXXXX
XXXXSSSSSrYSSwwwwwwS2222222SSSccScSSSSSSSSSSSScSSSSS22SSSSSSSSSSSXXXXXXXXXXXXXXXXXXXX
XXXXSSSSSSSrSSwwwwwSSSSSSS22SSSScSSrrSSSSSSScccSSS222SSSSSSSSSXSXXXXXXXXXXXXXXXXXSSSS
XXXXSSSSSSSYSSSwwSSrSSSSSSS2SSSSSSSSSSSSSSSScSSSS22SSSSSSSSSSXXXXXXXXXXXXXXXXXXXSSSSS
XXXXSSSSSSSrSSSwwSYrSSSScSS22SSccSSYSSSSSSScSSSS22SSSSSSSSSSSXXXXXXXXXXXXXXXXXSSSSrSS
XXXXSSSScSSrSSSwwSrSSSScScSS2SSScSrSSSSrSSScSSSS2SSSSSSSSSSSXXXXXXXXXXXXXXXXXSSSSSSSS
XXXXXSSSSSrYSSSwwSSSSSSSSSSS22SSSSSSrSSrSSccSS222SSSSSSSSSSXXXXXXXXXXXXXXXXXSSYSYSrYS
XXXXXSSScSSrrSSwwSSSSScSSSSSS22SSSSSSSYSSSSSS22SSSSSSSSSSSSXXXXXXXXXXXXXXXXSSSSSSSrrS
XXXXXSSScSSSSSSwwSSSSScccSScSS22SSccS1S1ScSS22SSSSSSSSSrSSXXXXXXXXXXXXXXXXXSSSSSSSSSS
XXXXXXSSccSSSSSwwSSSSScccSSScSS22SSc12SSr1S22SScSSSSSSYrSSXXXXXXXXXXXXXXXXSSSSSSSSYSS
XXXXXXXSSccSSSwwwSSSScSSccSSSScS222SS22SSS22ScccSSSSSSrSSSXXXXXXXXXXXXXXXXSSSSSYSSSSS
XXXXXXXSSSSSSSwwSSSSccSSScccSSSSSS22S1Sr122ScrSSSSSSSSSSSSXXXXXXXXXXXXXXXwwSSSSSSSSSr
XXXXXXXXSSSSSSwwSSSSccSSSSSSSSSSSSSS22SS2SSScSSSSSSSSSSSSSXXXXXXXXXXXXXXXXwSSSYSSSrSS
XXXXXXXXXSSSSSwwSSScScSSSSSSSSSScSrSS2222SScrSSccSSSSSSSSSXXXXXXXXwwwwwXXXXwwSSSSYrrS
XXXXXXXXXXSSSSwwSSScSSSSwSSSSSSrYSYSrS22SSrSSSSSSSSSSrSYSSSXXXXXXXSSSSwXXXXXwwSSSSSYS
XXXXXXXXXXXSSwwwSSScSSSSSSSSSSSSSwwrS22cScSSScSSSSSSSSSrrSSXXXXXXXSSSSSwXXXXXwSSSSSSS
XXXXXXXXXXXSSwwSSSSSccSSSS211SSrSYSS22SrrSSSSSSSSSSSSSSSSSSXXXXXXXXSSSSSwXXXXwwSSSSSS
XXXXXXXXXXXwwwSSSSSSSSSSS1SSS2SSSSSS2ScSSSSSSSSccSSSSSSSSSSXXXXXXXXSSYrSSwwXXXXwSYrSS
XXXXXXXXXXwwwSSSSSScSSSSS1SSS2SSSS222rSSSSSSSSSSSSSSSSSSSSSXXXXXXXXXSrSSSSwXXXXwSYYrY
XXXXXXXXXwwwSSSSScSSSSSSS2211SSSS22SSSSccrYSSSSSSSSccSSSSSSSXXXXXXXXXSSYSSwwXXXwSSrSS
XXXXXXXXXwwSSSSSScSSSSSSSSSSSSS222SSccSSSSSSSSSSccccSSSSSSSSXXXXXXXXXXSrSSSSwXXwwSSSS
XXXXXXXXXSSSSSSSccSccSSSSSSSSSS2SSSccSSSSSrSSSSccSSSSSSSSSSSSXXXXXXXXXSSSSSSwwwwwSSSS
XXXXXXXXXSSSSSSScSSScccScSSSSS22SSScSSSSSSSSSSSSSSSSSSSSSSSSSSXXXXXXXXXSSSSSSwwwwSSSS
XXXXXXXXXSSSScccSSSSSSSccSSSS22SSSScSSccSSScSSSSSScccccSSSSSSSSSXXXXXXXXSSSrSSSSSSSSS
XXXXXXXXSSSSccSccSSSSSSSSSSS22SSSSccSSSSSSccSSSSSccSSSScSSSSSSSSSXXXXXXXXSSSSSSSSSSYS
XXXXXXXXSSSScSSSScScccScrSSS2SSScSSSSSSSSccSSSSSSSSSSSSSSSSSSSSSSXXXXXXXXXXSYrSrYrSSS
XXXXXXXSSSScSSScScccSSSccSSS2ScrccrSSSSSSccSSSScSSSSSSSSSSSSSSSSSSXXXXXXXXXXXSSSSSSSS
XXXXXXSSSSScSSccSccSSSSScrSS2SSSSccSSSSSccSSSSSSSSSSSSSSSSSSSSSSSXXXXXXXXXXXXXXXXSSSS
XXXXXSSSSSScSSSccccSSSSScSSS2SSSSSrSSSSSSSSSSrYSSSSSSSSSSSSSScrSSXXXXXXXXXXXXXXXXXXXX
XXXXXSSSSSSSSccccccSSSSScrSS2SSSSSccSSSSSSSSSSSSSSSSSSSSSSSSScSSSSXXXXXXXXXXXXXXXXXXX
XXXXXSSSSSSccScSSccSSSSSrcSS2SSScccSSSSSSrrYSrrSSrSYSwwwSSSSSSrrSXXXXXXXXXXXXXXXXXXXX
XXXXXSSSSSSSccSccccSSSSScSSS2SrSSSrSSSSSSSSSrSSSrSSSSwwwSSSSSSSSSXXXXXXXXXXXXXXXXXXXX
XXXXSSSSSSSccScScccSSSSSccrS2SSSSrSSSSSSSSSSSSSSSSSSwwXwSSSSrYSYSXXXXXXXXXXXXXXXXXXXX
XXXXSSSSSScSScSSccSSScccSrcS2SSSSSSSSSSSSSSSSSSSSSSSwXXwSSScSSSYSXXXXXXXXXXXXXXXXXXXX
XXXXSSSSSScScccccSSSSSSSSSSS2SSSScccccccSSSSSSSSSSSSwXXwSSrYSSSSSXXXXXXXXXXXXXXXXXXXX
XXXXSSSSSSccSSSSSSSSScSSSSSS2SSSScSSSSScSSSSSSSSSSSSwXXwwSScSSrSSSXXXXXXXXXXXXXXXXXXX
XXXXSSSSSScSSSSSSSScSScSSrS22SSSScSSScSSSSSSS1SSSSSSwXXXwSScYcSrSSXXXXXXXXXXXXXXXXXXX
XXXXSSSSSScSSSSSSSSSSScSSSS2SSSScScSScSSSSSS121SSSSSwXXXwSSSScYSrXXXXXXXXXXXXXXXXXXXX
XXXSSSSSSScccSSSSSSSSSSSSS22SSrSSccSSSSSSSS12221SSSSwXXXwSSrYScSSXXXXXXXXXXXXXXXXXXXX
XXXSSSSSSccccSSSccScSSSSSS2SSSSSSSSSSSSS11122221SSSwwXXXwwSSSSSSSSXXXXXXXXXXXXXXXXXXX
XXXSSSSSccccSSYSSSScSSSSrS2SSrS222SSSSS122222221SSSwXXXXXwSSSSSSSXXXXXXXXXXXXXXXXXXXX
XXXSSScScccSSSSSSSScSSSSSS2SS222S22SSSSS22222221SSSXXXXXXXXXXXSSSXXXXXXXXXXXXXXXXXXXX
XXSSSSccScSSS1111SScSSSSSS2222rrYS22222222222221SSSXXXXXXXXXXXXXXXXXXXXXXXXXXXXXXXXXX
XXSSSSccSSSS122221SSScSSSS2SSSSSScrSSSS122222221SSSXXXXXXXXXXXXXXXXXXXXXXXXXXXXXXXXXX
XSSSSScSSSSS122222SS2222222SSSSSSrSSSSS122222221SSSXXXXXXXXXXXXXXXXXXXXXXXXXXXXXXXXXX
XSSSSScScSSS122222222SSwwr222SSSSSSSSSSS1111111SSSSSXXXXXXXXXXXXXXXXXXXXXXXXXXXXXXXXX
XSSSSScccSSS122221SSSSrwwwwwwwwSScSSSSSSSSSSSSSSSSSSSXXXXXXXXXXXXXXXXXXXXXXXXXXXXXXXX
XXSSSSccSSSSS1111SSSSSwwXXwXwwwrSSccSSSSSSYSSSSSSSSSSXXXXXXXXXXXXXXXXXXXXXXXXXXXXXXXX
XXXSSSSSSSccSSSSSScSSSwXXXXXXXwwSSccSSSScSSSSSSSSSSSSSXXXXXXXXXXXXXXXXXXXXXXXXXXXXXXX
XXXXSSSSSSSSSSSccSccSSwwXXXXXXwwSSScSSSSSSSSSScSSSSSSSXXXXXXXXXXXXXXXXXXXXXXXXXXXXXXX
XXXXXSSSSSSSSSSSSSccSrwwwXXXXXwwSScScSSSSSSSSSSSSSSSSXXXXXXXXXXXXXXXXXXXXXXXXXXXXXXXX
XXXXXXwSSScScScSccccSSSwwXXXXXwwSSSSSccSSSSSSSSSSSSSXXXXXXXXXXXXXXXXXXXXXXXXXXXXXXXXX
XXXXXXwwSSSScSSSSSccSSSwwwXXXwwrSSSScccSSSSSSSSSSSSXXXXXXXXXXXXXXXXXXXXXXXXXXXXXXXXXX
XXXXXXXwwSSSSccSSSSccSSSSwXXXwrSSSccSScSSScSSSSSSSXXXXXXXXXXXXXXXXXXXXXXXXXXXXXXXXXXX
XXXXXXXXwwSSSSScSSSSSSSSwXXwwSSSSScSSSccSScSSSSSSXXXXXXXXXXXXXXXXXXXXXXXXXXXXXXXXXXXX
XXXXXXXXXwwSSSSSSSSSSSSSwXwSSSSSSSSSSSSSSSccSSSSXXXXXXXXXXXXXXXXXXXXXXXXXXXXXXXXXXXXX
XXXXXXXXXXwwSSSSSSSSSSSSwXSSSSSSSSSSSSSSSSSSSSSXXXXXXXXXXXXXXXXXXXXXXXXXXXXXXXXXXXXXX
XXXXXXXXXXXwwSSSwwwSSSSSwXSSSSSSSXXXSSSSSSSSSSSSXXXXXXXXXXXXXXXXXXXXXXXXXXXXXXXXXXXXX
XXXXXXXXXXXXwwSSwXwwwwSwwXSSSSSSXXXXSSXXXXXXXSSXXXXXXXXXXXXXXXXXXXXXXXXXXXXXXXXXXXXXX
XXXXXXXXXXXXXwwwwXXXXwwwXXXXXXXXXXXXXXXXXXXXXXXXXXXXXXXXXXXXXXXXXXXXXXXXXXXXXXXXXXXXX
XXXXXXXXXXXXXXXwXXXXXXXXXXXXXXXXXXXXXXXXXXXXXXXXXXXXXXXXXXXXXXXXXXXXXXXXXXXXXXXXXXXXX
XXXXXXXXXXXXXXXXXXXXXXXXXXXXXXXXXXXXXXXXXXXXXXXXXXXXXXXXXXXXXXXXXXXXXXXXXXXXXXXXXXXXX